11111111111
1000E000001
10000000001
101100C0001
10000000001
10P00000001
10111111111