11111111111111111111111111111
1EH0010v1C1C000VC000000001H01
1100v000101000001H00000001111
10V00v000010H010100h1H0000001
1P0v00V0111100111010100C0C001
100011111001000010C010C0C0C01
100001V00h0110Vv10C010C000C01
1000v00000001v0010C0100C0C001
101000000v10000000001000C0001
11111111111111111111111111111