1111111111
10E0000001
1000000001
10000000P1
1111111111