111111111111
1C10010100C1
1000000H0011
111011100001
1C0001000PE1
111111111111