111111111111
10P100000001
100100100001
10000E100C01
111111111111