11111111111111111111111111111
100P10100C10000000100010000C1
10111010111011111011101011111
10000000000010000000000000001
10111111101110111111110111101
1C0000000000100C0010000000001
11101110111011111010111011111
100000100C10100000000E10000C1
11111111111111111111111111111