1111111111
10P0000E01
1111111111