11111111111111111
1P10100000101C1C1
100v0010100010001
11101110110111V01
1E101C0001C000001
10111111111011111
1000000H0000000C1
11111111111111111