111111111111111111111111111
10000000C100000000000001CC1
1P0v00000100000v01H00001CC1
1000v000010000v001H00001CC1
10000v0001000v0001H00001001
100000v00100v00001H00001001
1E00000v010v000001H00001001
1000000000000000C1000000001
111111111111111111111111111