111111111111111111111111111
1P000000C100000000000000001
100v0000010V0000010000000h1
1000v0000100V000010H0000001
10000v0001000V000100h000001
100000v0010000V00100H000001
1E00000v0100000V0100000H001
1000000000000000C10000000C1
111111111111111111111111111