11111111111111111
1P10100000001C001
100v0010010011001
11101110010010V01
1E101C0001C000001
10111111111101111
1000000H0000000C1
11111111111111111