111111111111
1C100001C001
100000H00011
111011100001
1C0001000PE1
111111111111