111111111111
10P1000E0001
100100100001
100000100C01
111111111111