11111111111111111
1P10100000001C1C1
100v0010100010101
11101110110110H01
1E101C0001C000001
10111111111011111
1000000H0000000C1
11111111111111111