11111111111111111111
1E000v000100010001C1
100000V1000100010001
100V0001111111110101
1C00v00000C101C0V101
11111111111101110101
1H0P0000000000000001
11111111111111111111