111111111111
10100001C001
10000H000001
111011100E01
1C0001000P01
111111111111