11111111111111111111
1E000v001000100001C1
10000010001000100001
100V0011111111100101
1C00000000C1001CV101
11111111111101110101
1H0P0000000000000001
11111111111111111111