11111111111
10000000001
10000000E01
11100000001
1C1000C0001
11100000001
10P00000001
11111111111