111111111
100000001
10X11E001
1000000C1
1P0000001
111111111