1 1 1 1 1 1 1 1
1 C 0 0 0 0 0 0 1
1 0 0 0 P 0 0 1
1 0 0 0 0 0 0 1
1 0 E 0 0 0 0 1
  1 1 1 1 1 1 1
      1