11111111111
10000000001
10000P00001
10000000001
100E0000001
100000000P1
11111111111