11111111
1C0000001
1000P001
10000001
10E00001
1111111
1