11111111111111111111
10E10000010000000001
10010000000000000P01
10010000000000111111
10000000000000000001
10111000000000000001
10000000001111000001
10000000001C00000001
10000000000000000001
11111111111111111111