11111111111111111111
10E10000010000000001
10010000000000000P01
10010000000000111111
1000000000000000V001
10111000000000000C01
1000000000111100V001
10000000001C00000001
100000H0000000000001
11111111111111111111